XXXXXXXXXXXXXXXXX
XWWWWWWWWWWWWWWWX
XWBBBMBBBBBBBBBWX
XWBWWWWBWBWWWWBWX
XWBWBBBBBBBBBWBWX
XWBWBWWWAWWWBWBWX
XWBWBW6XXX7WBWBWX
DDBBBWXXXXXWBBBDD
XWBWBWXX8XXWBWBWX
XWBWBWWWWWWWBWBWX
XWBWBBBBBBBBBWBWX
XWBWWWWBWBWWWWBWX
XWBBBBBBBBBBBBBWX
XWWWWWWWWWWWWWWWX
XXXXXXXXXXXXXXXXX