XXXXXXXXXXXXXXXXX
XWWWWWWWWWWWWWWWX
XWPBBBBBBBBBBBBWX
XWBWWWWBWBWWWWBWX
XWBWBBBBBBBBBWBWX
XWBWBWWWAWWWBWBWX
XWBWBW3XXX4WBWBWX
DDBBBWXXXXXWBBBDD
XWBWBWXX5XXWBWBWX
XWBWBWWWWWWWBWBWX
XWBWBVBBBBBBBWBWX
XWBWWWWBWBWWWWBWX
XWBBBBBBBBBBBBBWX
XWWWWWWWWWWWWWWWX
XXXXXXXXXXXXXXXXX