XXXXXXXXXXXXXXXXX
XWWWWWWWWWWWWWWWX
XWPBBBBBBBBBBBBWX
XWBWWWWBWBWWWWBWX
XWBWBBBBBBBBBWCWX
XWBWBWWWAWWWBWBWX
XWBWBW0XXX2WBWBWX
DDBBBWXXXXXWBBBDD
XWBWBWXX1XXWBWBWX
XWBWBWWWWWWWBWBWX
XWBWBBBBBBBBBWBWX
XWBWWWWBWBWWWWBWX
XWBBBBBBBBBBBBBWX
XWWWWWWWWWWWWWWWX
XXXXXXXXXXXXXXXXX